.##.#.#..#.
##..#.#.##.
#.#.####.##
##.#..#..##
#...@..####
##.#...####
.#.##.#.###
#.##...###.
.#...#####.
####.#..#..
##.....#.#.
