##..#...#.#
...#.#.#...
.#.#.###..#
###..###.##
.#.#@..#...
#..####..##
.#.##..###.
##.###..#..
##.#..###..
....####..#
.##..#.....
