#...##.#.#.
.###.#...#.
#..###..#..
#..#..###.#
##..@.#..##
..#..#####.
#.#..#..#..
#..###..#.#
##.#...####
##.##..####
##.#.#.###.
