###..####.#
#..##..##.#
#..#..#####
##..#......
.#..@##....
..##..####.
...#.#.##.#
#...#######
###.#.#.#.#
#....####.#
.#..##..#.#
