.#.#.###..#
.###.#.##..
#.#...####.
.#.#.###.##
###.@#####.
.#.#.#.....
#....#....#
..#.##..##.
..#...#.#.#
.####.#...#
#.#.#####.#
