.#.#.##...#
#.#.####...
.######.#..
#.##..#..##
##.#@..##.#
#..#.....#.
####..#...#
##.#.#.#.#.
###..#..##.
##.#...###.
###..##..#.
