###..#.#..#
#.##.##.###
..#.#.#...#
.#.#...##.#
....@####.#
#####.####.
...###..###
..#.##.#...
###.##...##
....#.###.#
.##.##.#...
