##.##..#...
#......####
#.##..#.#.#
##..#..#.#.
###.@.#..##
.#.....##.#
..##.##.##.
#...#####..
....##.##..
...#.#..###
.##.#.#.###
