#.#....###.
####.#.#.#.
.##..#...#.
...##......
.#..@.###.#
.#####.##.#
....####..#
..##.#..#.#
....###..#.
.##.###...#
#.#.#.#...#
