#....####..
..##.##....
...#..#..##
#...######.
..#.@#.....
.###.##.#.#
###.##..#.#
..#...###..
#......#..#
.#..###....
.#.#.###.#.
