.#...####..
#.##.####..
#..##..#.##
#....##..##
...#@.#.#..
..#....#...
###...#.#..
####..##.##
..##.##.##.
...#.#.#..#
#.....####.
