..#...#...#
##..###.#.#
.#.#.##....
.##.##..##.
##.#@#..#.#
##...#...##
...#.#.##..
..##.....#.
######....#
...##.#.#..
.####..###.
