#.#......#.
.#.###.#.##
....#..##.#
####..####.
...#@.####.
##....##.#.
###..###..#
#.##..#.###
######.##.#
##...#.##..
.#...#..###
