###.....#..
##.###.#...
##...#..##.
#.#.##...#.
....@###.##
....###..#.
#.###.##.##
#...#..##.#
#.###.#....
#.#..#.#.#.
.##..###.#.
