.#.###.#..#
#...#.###.#
..###.#.##.
...####.#..
...#@#.##..
#.###.#....
..####.....
.####.#.###
.#..##..#..
#.#.##..##.
##.....###.
