.#.#...###.
..#.#.##..#
..#.###.#.#
.#.#.#.##..
....@...#..
.##.##.#...
.#.#.#.##.#
..###.#....
#.#.#..##.#
#.#.#...#..
.#######...
