#.##.##...#
..###....##
##..##.#..#
.#..####...
##..@#.....
....#.#..##
#....####..
.#####.#.#.
..##...#..#
.#...######
.#.#......#
