#.###.###.#
.#..####.#.
.##.#...#.#
##....#..##
.#..@..#...
.##.#..##.#
#..#.##..##
####.#.##..
..#.#.#..##
#.##..#..##
........##.
