.###..##..#
######.#...
##.....#.#.
##...#...#.
.#.#@..##..
####.#.###.
##.#.##....
##.....###.
#.##.#..##.
##.#.#.##.#
#.##.....##
