##.#####.#.
...#.#..#.#
######...##
#.#..##.##.
..#.@##...#
.#.#.#####.
..####..#.#
##...#..#..
....#..####
.#.#.####..
#.#..###.##
