..####....#
#.##.#...#.
##.###..##.
##..##.#.##
####@.####.
..#.#..###.
#..#...#.#.
#...####.##
##.######..
#..##.#.##.
...####..#.
