###.#..#...
..##...#..#
#..####.##.
..#..####.#
..##@.#.##.
##..#.###..
#.#..###...
##.#.#..#.#
####.#..#.#
.##..##.#..
#.....###.#
