..#.....##.
....#.#.###
...........
...#...#..#
#.##@#...#.
##......###
#.#####.##.
#...###..##
##.....####
#..#######.
#..#.#..###
