........###
#.#.##.##.#
.#.####.##.
.##.##.#.#.
#..#@###..#
..###.#..##
.#.#.#.#.##
.###....##.
.###..#####
##.####..##
....#.#....
