.#.###....#
..##.##..#.
#.##.####..
#.#..#.#..#
##..@.#####
##.#.#.##..
...#......#
#..#.#####.
#.######.##
##...###.#.
##.#.......
