.....###...
##..#####..
..#####....
.#..#......
#..#@...#.#
#######..##
.#..###.##.
..#.....#.#
..#....#.##
.#.#..#.###
.#.#....###
