...#..##.##
.##.##..#.#
###.#.###.#
#..####..#.
####@##..#.
#.###..#.##
....##..###
........#.#
#.#..#..###
..##..##.#.
.###.######
