###..#.##..
...###..#..
###..##....
#...###....
..#.@#..#.#
.#..####.##
.###.##...#
.#.##.###..
####...###.
###..#.##.#
.#.#.#...#.
