##.##.##..#
.#.###....#
###...##.##
#....#.#.#.
#.#.@.#.##.
#.#...#.#.#
..#...##.#.
##..##.####
##.##...###
####...#.#.
.#..#.##..#
