###.#....##
#.#####...#
.##..######
...#.##.#.#
.#..@##...#
..#..#.#...
#..#...#.#.
.######.#..
#.##...####
##.#####..#
...###.#..#
