###...#..##
######.#..#
#......#.##
.##...#.#..
###.@..#.#.
..#######.#
##......###
.###..#####
###.#......
#..#.#.##..
#..#...#...
