.###.###.##
###..##...#
.#.##.##..#
.####.#..##
.###@##.#.#
##......#.#
.######.#..
..#.##.#.#.
..##...####
.##.#.##.##
###.##.##..
