#..#.####.#
#.##.#.#.#.
...##....##
..##..##.#.
.###@.##.##
####...#...
####.#.###.
##..##.#..#
.#...##.##.
##.#######.
##...###...
