.......#..#
#.#.####..#
###.#.###..
#..#.......
....@....#.
##.#..#....
###..#...#.
#.#...#.#..
#####..#.##
.#.#.#.#.#.
#...##.####
