.#..######.
#..#...####
#...##.....
......##...
###.@###...
##..#..###.
.##.####.##
.#.####..#.
#.#####....
####..#....
#.#...####.
