##....#....
..#..#.#...
##..#.##.#.
.#.##..###.
##..@####..
.#..#...###
#.##..#.##.
...##..#.##
.###..##.##
...####....
#######...#
