#.###.#.###
#####.#..##
.##.#....##
..#.#.#.#..
....@...#..
#.#..#.#.##
....##.####
####.###.#.
...###...#.
.#..#.##...
.#..#...###
