.###..#.###
.#.##..#.##
#..######..
.##.#.##.#.
.#.#@#..##.
##...#.#...
##.##....#.
#.##..#....
#.#..##.#.#
#..##..##..
.##..#..#.#
