..#.##...#.
#.#...##.#.
.##.##..#.#
###.#..#.#.
#.#.@##.#..
##.#.#..##.
...#...##.#
.##.#.#.#.#
.###...#..#
...#..###..
#.#..##....
