...##..##..
.###.#.#..#
#.#..#.##.#
#.#.#.#####
.#..@...##.
.#..###.#.#
..#.#####.#
.###.##...#
##..###.###
...#.###..#
.#..#.....#
