...####.###
.##......#.
.##..#.##.#
....#...##.
.###@...###
#...##.#...
#####.##...
.##..#..#.#
.#...##.###
.#..##...#.
###....##..
