#....##.#..
.#.####....
#.##....###
######...##
####@##...#
.#..####.#.
##.#.##..##
.###.######
..##..#.###
..##.#.#.##
....##..##.
