..##..##...
...##.#...#
....###....
...#.##.###
..#.@#...##
###..#.####
###..#..##.
#.##...####
##.##..#...
......##.##
#..#...#...
