..###..#.##
#.##...#..#
##.####.#..
##..#.#....
###.@.....#
##.###....#
....#...#.#
#..#..#.#.#
.#.##..###.
#....#...#.
.###....#.#
