....##..#..
....##...##
##...##.#..
#.#.#####..
..#.@...###
###....###.
.###..#.#.#
..###.###.#
#.####.#...
.....##..##
.#...#.##..
