##.####.###
##....#.###
.###..#.#..
..###..#.##
.#..@..##..
#####...#..
..##....#.#
.#.##......
##.#...#.##
#...#..#.##
.#..###..#.
