.#.#...##..
#..#.####.#
.#.#.#.#..#
####.##.##.
...#@##..##
..#.#.#.###
.###....#.#
.###.....#.
..##...#..#
####..###.#
####....###
