..##..#...#
..#......#.
..##.###.#.
....#.....#
..##@###...
#.#####.#.#
.#.##..#...
#.#.....#.#
##.##.#.#.#
.....####.#
.##.###.###
