.#..###.###
#...###.##.
#.#.###.###
....##.#.##
#...@......
#...##.##..
##..##..#..
#.##..####.
.#...##....
.####....#.
..###.....#
