..####.##..
###.###.##.
...#...#.##
#.#....##.#
..#.@##..#.
.####...##.
#......#.##
.#.#.##.#.#
......##.##
..##..###..
#...#...#.#
