.###.#..###
#.##.#..#..
..####.##..
.....#.#..#
#.##@..#.#.
#...##..#.#
##.##...##.
###.#..#.#.
#.#.#.##..#
.#...####.#
#....#.#.##
