..##...#..#
##...###.#.
..#...#...#
#.#..##.###
#...@#.#...
##..###..#.
#.#.#..#...
#.#.#.##...
#..#.#####.
...#...##..
#.##.#..###
