#..#..#....
..###..####
..#....#..#
..####.####
#.##@##.##.
##.####...#
####..#.#..
#.###..####
#..#####.##
.#.####.#..
....#..####
