.##.##..###
.##.##....#
.###.###.#.
.#..##.#.##
.###@.#...#
#.##......#
#.##..##..#
.##...##.#.
#...###...#
...#.##..##
#.##.#.#...
