.#..#####..
####..#.#..
#.#.#.#.#.#
.######..#.
####@.#...#
.##.#.#####
###########
.#...####.#
#.##.#.#.#.
.#.#..##...
.##..#.#.##
