..#.#..#...
.#####..##.
#.##.#.####
.###..##..#
.##.@.####.
##.##...#.#
#.#.#..#...
#.#.#.##..#
.#.#.##.#..
#.##.####.#
.###....#..
