#.##..#..##
.#.#####.#.
###.##..###
.##.####..#
.#.#@..##.#
##...###.#.
...###.#...
....#..##..
..#...#.###
.##...###.#
######.....
