..#..##.###
...#.##.#..
#...#####..
##.##...##.
#..#@.....#
#.#...#...#
..##.##.#.#
#.##...####
#..#.#..#.#
..#...#.##.
..#..##.#..
