.#..#.#..#.
#.#.##.#..#
.###.###...
#.##.#.##..
##..@.##.#.
#.#...#####
.##...##.#.
#.##...#..#
...##.#.#.#
#..#....#.#
..#..###..#
