.##.##..##.
#.#..#..#.#
.#.#..#.##.
..#...####.
##.#@##.##.
.#..###.##.
..#..#####.
...####.#.#
...#.####..
.##..##.#.#
...#####...
