..#.##.##.#
.....#.####
..####..#..
#.##.#..###
#...@...#.#
##.##.#.#..
.#....#.#..
####...#...
#.###.###.#
.#.#..#####
.#####..#..
