..#.##..#.#
.###..###.#
####.#...#.
##....#.#.#
###.@#.#.##
..#.#.....#
###.##.##..
..###.#.###
##########.
.#.#..###.#
.##.#.#..##
