.##..##..##
.###.###.##
.#.#.##..#.
####...#...
.###@#....#
.#.#.#.##..
####.#.##..
#........#.
.......#...
#.#.##.##.#
#.#..###.#.
