#.##.#.#.#.
#.###....#.
.#.##......
#..#.#.##..
##.#@.##...
.#......#..
###.##.##..
.##.#.#.#..
..#.#...##.
#..##.#..##
.##.....#.#
