..#..#.#.##
##..###..#.
###.######.
#.#......##
...#@.....#
##..#..##..
##...####..
.###.######
#####..#...
##...#.##.#
..#...##.##
