##.###...#.
..#...##...
#.......##.
#...#.#.#..
#.##@.....#
#..#.##.#.#
.###.#.###.
###..#..###
..######...
#.###.#.#.#
#...#....#.
