.##..#...##
.#..#.#.##.
.#.#...###.
.#.##..#...
#.##@.#....
##########.
.#...####.#
#.#...#....
.#..##.....
..#.#..#.#.
###........
