.##...#....
...###.#.##
#..#..#.###
#####...###
###.@#...#.
.#####....#
##.#.##.#..
#..#.......
.#.##.#.#.#
####...#.##
#..#..#.##.
