.....#####.
#..###...#.
..#...#.###
.#...###.##
..##@..#.#.
..####.#.##
#.#.#.##..#
.####..#..#
#.#..######
#.....#....
######.#..#
