####.##.#.#
#....#..###
.#...#...#.
..###..##.#
.##.@##....
..#######.#
..#..###.##
##.#....###
.....#.##.#
..###.#.#..
#....###.#.
