.###.####.#
.#.###.####
.#...#.#..#
...#..#...#
.###@..##..
..###..#...
.###.#..#..
#.##...#..#
..###......
###..#....#
..##.......
