..#.###..##
......#..##
..#...#..##
..#..#..#..
#.##@#...#.
.###.......
.#...#.###.
..#..##...#
######..#..
...###.###.
.#.##.##.#.
