.#.#.#.##.#
.##...#....
#.#....#.#.
......##..#
....@.#.#.#
.####.#...#
#.#..##.###
..#.####.#.
.###......#
.#...##.#..
#.##.#..###
