###..#####.
...###.###.
...#..##..#
####..#####
.##.@.#..#.
..###.#.##.
.##..#.#...
...#..#.#..
.#..##....#
..#.#.###.#
...#..#.#..
