.#....#####
#..#...#.##
#.######..#
.#.####.#..
####@#.#.#.
#.#.#......
#.#..#....#
..###..#..#
.####..##..
#..#.#..##.
###.##.###.
