.##....####
..#######..
.######.###
#.##..##...
#...@#..##.
##...##..#.
#..##...##.
..######...
.######....
...#..####.
###.....###
