#.##.##..##
.###..#.###
#.#.###..##
##########.
#...@...#..
...........
..#.##.###.
#####.#.#..
.#..###...#
.#.##.###.#
##.#.######
