#...#.#.#..
...##.#####
...##..#...
#######.##.
.#.#@......
#######..##
#..#..#.##.
.##...##.#.
###..##...#
#..#..#####
##..#.####.
