#..#....##.
..##..#.#.#
#..#.#....#
..#.#..####
##.#@.##.#.
.#..###.###
#.#.#.#.##.
..#.#...#.#
..#...#...#
####.######
#...#.#####
