####..#..#.
###...##...
..##.#.####
#.##.#.##..
.#.#@.#.#.#
##.#..###..
...#.#..#..
#.###.####.
##.#.###.##
##..#..####
#.#.##.###.
