##.#..#####
##..#.#..#.
....##.....
#.##.##....
#...@..#...
.###.###...
#.#.#..##.#
.#.#.#.###.
...#.#.#..#
..#...#.#..
#.#####...#
