.####.#####
.####.#.#.#
.########..
.#####...#.
.###@..#.##
#.##.....##
#.##.#...#.
#.##.#####.
#.###......
.###...####
..####.###.
