##.....#.#.
#....#.#.##
.#.##.##..#
.#.#.#..###
####@......
.#######..#
......####.
..##....###
.#..##...#.
...##..##.#
##......###
