#.....#.###
##.##.#####
.....#..##.
#.#...#.#.#
.#..@######
....#.####.
#.##..#..##
...#...###.
....#..#.#.
.#..#...#..
#####..#.#.
