##.#..#..#.
####..#....
.....#.##..
#.##...#...
..##@##..#.
##..#...#.#
##.###...#.
..##.###...
#..#.#.###.
####.###..#
.#......#..
