##..###..#.
###......#.
...####...#
##.#......#
#...@.#...#
.##......##
##.####..#.
#..####.##.
#####.#...#
##.##..#...
#.##..##...
