##...#.#..#
#.######..#
...#.#.#.##
.##.#.##.##
...#@.....#
..#.....#..
.#.#.##...#
###.####...
#.....#.##.
#..#..###..
#..#.###..#
