.##.#.####.
#..##.#....
#..##..###.
.###.#...##
...#@#..##.
#.####..#..
..##.#..##.
...#...##.#
.##...###..
..##....#..
..#...##.#.
