##.#######.
###.#.#..##
.#....#.##.
#...#.#.#..
.#.#@.#.###
#.#..####.#
.#######...
.####...##.
..#.....###
#.#...#....
##..###...#
