#.##.....#.
#..###...#.
##....##.##
#..##...###
#..#@..###.
#.####.#...
#....#.#.#.
#.#.##.#.##
.##...##.##
#..#.#..#..
####.##.#..
