#######...#
..##..#..#.
.#.#..##...
......#....
...#@#....#
#.#...###.#
##...#....#
....#.#.###
.#.###..##.
####..##.##
#.##..#####
