..#....#.#.
..##.#..#..
.#.##.#...#
..#.#......
##.#@.#..#.
..#.#...###
#.#.##..#..
#.#..##.#..
##.#.##.##.
......##.#.
###..##.##.
