#..#.#.....
...#...#.##
#.#.#...#..
...#...##.#
.#..@.##.##
###...##...
#.#.#..##.#
.#.#.##.##.
##.####.###
.##.....##.
.#.####..#.
