.#..#......
#...##....#
..#.#......
##..##.#...
##.#@.###.#
...###...##
..#..#.###.
..###.####.
#..##.###.#
####.#.#.##
.##.#..##.#
