#.########.
#.#....#.#.
.#....##.##
..##...##..
.###@.###.#
.....#.....
#.#....#...
#..##.##.#.
.##......##
..#.#.#..#.
..#..#.#...
