#....#...#.
..##..#..##
..####.####
.##########
...#@#.....
.#...##..##
###.###.##.
#..##.##.#.
###.##.#...
#........#.
.#####..#.#
