.#.#.##.#.#
###..#...#.
#...#######
...#.#....#
##.#@..#.#.
.#.#.###.#.
.##.#.##.#.
##...######
#.####.#.#.
###........
#....###.#.
