#....##...#
..###.#.#..
###.##...##
.....###..#
###.@.#.###
...#..##.##
####.##....
.....##..##
.######...#
##..#....#.
.####..#.##
