###...##.##
##..###..#.
##..####.#.
#....#.####
.##.@.###.#
#....#...##
..####..##.
####...#..#
#.....#...#
#######....
.#..###..#.
