...##..####
..##...##..
.....###.#.
#..#..#....
.##.@.....#
.#.####.###
.##.####..#
..##.##....
..#...###..
.###.#.##..
......#..#.
